11111111111111111111111
1CC00000000000100000011
1C0000000000000P000C001
11101100001111000000001
1E001000001111000011001
11111111111111111111111